RRRRRR                                  RRRRR
R                                           R
R                                           R
R                                           R
R                                           R
R                                           R
R        C                                  R
R              RR  RR  RR       RRRR        R
R       RRR                                 R
R                                           R
R   1                                       R
PPPPPPPPPPPPPPPPPPPPPPPPPPPPPPPPPPPPPPPPPPPPP
