RRRRRR                RRRRR
R                         R
R                         R
R                         R
R                         R
R                         R
R        C                R
R             RRRR        R
R       RRR               R
R                         R
R   1                  F  R
RRRRRRRRRRRRRRRR   RRRRRRRR
