RRRRRR                                                             RRRRRR
R                                                                       R
R                                                                       R
R                                                                       R
R                                                                       R
R                                           C                           R
R           C             C           C           C                     R
R                         RR       RRRR                                 R
R          RRRRR                                                        R
R                                                                       R
R   1                                                                F  R
RRRRRRRRRRRRRRRRRRRRRRRR    RRRRRRRRRRRRR      RRRRRRRRRRR  RRRRRRRRRRRRR
